0000000000000001111000000000000000000000000000000000
0000000000000001111000000000000100000000000000000000
0000000000000001111000000000000100000000000000000000
0000000000000001111010000000000100000000000000000000
0000000000000001111010000000000100000000000000000000
0d00000000022201111010000000000100000000000000000000
0000000000211101111010000000000100000000000000000000
0000000002111100000010000000000100000000000000000000
0000000021111100000010000000200100000000000000000000
0000002011111100000010020020000100000000000000000000
0011100011111101111110000000000111111111100000000000
1111100011111101111110000000000111111111111111111111
1111100011111101111110000000000111111111111111111111