00000000000000000011110000000000000000000
00000000000000011110000000000001000000000
00000000000000011110000000000001000000000
00000000000000011110100000000001000000000
00000000000000011110100000000001000000000
00000000000222011110100000000001000000000
00000000002111011110100000000001000000000
00000000021111011110100000000001000000000
00000000211111000000100000002001000000000
00000020111111000000100200200001000000000
10111000111111011111100000000001111111000
11111000111111011111100000000001111111111
11111000111111011111100000000001111111111