222200000000002000000000000000001000
111100000000001000000000000000001011
111100000022201000000000000000001000
111101000000101000000000000000001000
111101002000101022220022000000001000
111101001000101011110011000000001000
111101000000001000010011000000000011
000001000000001000010011000000000011
000001000000000000010011000000000011
000001000000000011010001000000000011
000101000000000000010000000000020011
110000000000001000010000002002000011

 








