
000000000000000000000000222222000000
000000000000000000000000111111000000
000000000000000000000000111111000000
000000000000000000000000000000000000
000000000222200000000000000000000002
000000002111120000000000000000000001
000000021111112000000000111111100021
000000211111111000000000111111100211
000002111111111000000000111111111111
000021111111111000011111111111111111
000211111111111020011111111111111111
222111111111111000011111111111111111




