22220000000000200000000000000000100000000000000000000000
11110000000000100000000000000000100000000000000000000000
11110000002220100000000000000000100000000000000000000000
11110100000010100000000000000000100000000000001100111111
11110100200010102222002200000000100000000011001100111111
11110100100010101111001100000000100000110011001100111111
11110100000000100001001100000000001100110011001100111111
00000100000000100001001100000000001100110011001100111111
00000100000000000001001100000000001100110011001100111111
00000100000000001101000100000000001100110011001100111111
00010100000000000001000000000002001100110011001100111111
11000000000000100001000000200200001100110011001100111111

 








