000000000000
000000000000
000000000000
100000000100
000000000000
000000000000
000000000000
000222220000
001111111000
011111111100
022222222200
011111111100