
0000000000000000000000002222220000000000000000000
0000000000000000000000001111110000000000000000000
0000000000000000000000001111110000000000000000000
0000000000000000000000000000000000000000000000000
0000000002222000000000000000000000020000020000000
0000000021111200000000000000000000010000010000000
0000000211111120000000001111111000210000210100010
0000002111111110000000001111111002110002110001000
0000021111111110000000001111111111111111110000000
0000211111111110000111111111111111111111110000000
0002111111111110200111111111111111111111110000000
2221111111111110000111111111111111111111110000000




